XX         5            XX
LX     I    I    I      XX
XX    XXXXXXXXXXXX      XX
XX      0       0       XX
XX     I         I      XX
XX    XXXXX   XXXXXX    XX
XX                      XX
XX       I     I        XX
XX    XXXXXXXXXXXXX     XX
XX                      XX
XX      I      I     I  XX
XX     XXXXXXXXXXXXXXX  XX
XX            5         XX
XX   I    I    I   I    XX
XX  XXXXXXXX  XXXXXXXX  XX
XXS               0     XX
XX      I      I        XX
XXXXXXXX   XXXXX   XXXXXXX