XX                      XX
LX                      XX
XX                      XX
XX                      XX
XX                      XX
XX                      XX
XX            0         XX
XX I                    XX
XXXX    XXXXXXXXXX    XXXX
XX        0             XX
XX             I        XX
XXXX   XXXXXXXXXXXX   XXXX
XX       0              XX
XX            I         XX
XXXX  XXXXXXXXXXXXXX  XXXX
XXS                     XX
XX            I         XX
XXXXRXXXXXXXXXXXXXXXXXXXXX